{
"af":"af",
"aa":"al",
"ae":"dz",
"as":"as",
"an":"ad",
"ao":"ao",
"am":"ai",
"ay":"aq",
"aq":"ag",
"ag":"ar",
"ai":"am",
"aw":"aw",
"at":"au",
"aca":"au",
"wea":"au",
"au":"at",
"aj":"az",
"bf":"bs",
"ba":"bh",
"bg":"bd",
"bb":"bb",
"bw":"by",
"be":"be",
"bh":"bz",
"dm":"bj",
"bm":"bm",
"bt":"bt",
"bo":"bo",
"bn":"ba",
"bs":"bw",
"bv":"bv",
"bl":"br",
"bi":"io",
"vb":"vg",
"bx":"bn",
"bu":"bg",
"uv":"bf",
"br":"mm",
"bd":"bi",
"cm":"cm",
"xxc":"ca",
"abc":"ca",
"bcc":"ca",
"dcu":"ca",
"mbc":"ca",
"nkc":"ca",
"nfc":"ca",
"ntc":"ca",
"nsc":"ca",
"nuc":"ca",
"onc":"ca",
"pic":"ca",
"quc":"ca",
"snc":"ca",
"ykc":"ca",
"cv":"cv",
"cj":"ky",
"cx":"cf",
"cd":"td",
"cl":"cl",
"cc":"cn",
"pf":"cn",
"ch":"tw",
"xa":"cx",
"xb":"cc",
"ck":"co",
"cq":"km",
"cf":"cg",
"cg":"cd",
"cw":"ck",
"xga":"au",
"cr":"cr",
"iv":"ci",
"ci":"hr",
"cu":"cu",
"cy":"cy",
"xr":"cz",
"dk":"dk",
"ft":"dj",
"dq":"dm",
"dr":"do",
"em":"tl",
"ec":"ec",
"ua":"eg",
"es":"sv",
"eg":"gq",
"ea":"er",
"er":"ee",
"et":"et",
"fk":"fk",
"fa":"fo",
"fj":"fj",
"fi":"fi",
"fr":"fr",
"fg":"gf",
"fp":"pf",
"fs":"tf",
"go":"ga",
"gm":"gm",
"gs":"ge",
"gw":"de",
"gh":"gh",
"gi":"gi",
"gr":"gr",
"gl":"gl",
"gd":"gd",
"gp":"gp",
"gu":"gu",
"gt":"gt",
"gv":"gn",
"pg":"gw",
"gy":"gy",
"ht":"ht",
"hm":"hm",
"vc":"va",
"ho":"hn",
"hu":"hu",
"ic":"is",
"ii":"in",
"io":"id",
"ir":"ir",
"iq":"iq",
"iy":"nt",
"ie":"ie",
"is":"il",
"it":"it",
"jm":"jm",
"ja":"jp",
"ji":"us",
"jo":"jo",
"cb":"kh",
"kz":"kz",
"ke":"ke",
"gb":"ki",
"kn":"kp",
"ko":"kr",
"kv":"rs",
"ku":"kw",
"kg":"kg",
"ls":"la",
"lv":"lv",
"le":"lb",
"lo":"ls",
"lb":"lr",
"ly":"ly",
"lh":"li",
"li":"lt",
"lu":"lu",
"xn":"mk",
"mg":"mg",
"mw":"mw",
"my":"my",
"xc":"mv",
"ml":"ml",
"mm":"mt",
"xe":"mh",
"mq":"mq",
"mu":"mr",
"mf":"mu",
"ot":"yt",
"mx":"mx",
"fm":"fm",
"xf":"us",
"mv":"md",
"mc":"mc",
"mp":"mn",
"mo":"me",
"mj":"ms",
"mr":"ma",
"mz":"mz",
"sx":"na",
"nu":"nr",
"np":"np",
"ne":"nl",
"na":"nl",
"nl":"nc",
"xna":"au",
"nz":"nz",
"nq":"ni",
"ng":"ne",
"nr":"ng",
"xh":"nu",
"xx":"xx",
"nx":"nf",
"nw":"mp",
"xoa":"au",
"no":"no",
"mk":"om",
"pk":"pk",
"pw":"pw",
"gz":"ps",
"pn":"pa",
"pp":"pg",
"py":"py",
"pe":"pe",
"ph":"ph",
"pc":"pn",
"pl":"pl",
"po":"pt",
"pr":"pr",
"qa":"qa",
"qea":"au",
"re":"re",
"rm":"ro",
"ru":"ru",
"rw":"rw",
"xj":"sh",
"xd":"kn",
"xk":"lc",
"xl":"pm",
"xm":"vc",
"ws":"ws",
"sm":"sm",
"sf":"st",
"su":"sa",
"sg":"sn",
"se":"sc",
"sl":"sl",
"si":"sg",
"xo":"sk",
"xv":"si",
"bp":"sb",
"so":"so",
"sa":"za",
"sxra":"au",
"xs":"gs",
"sp":"es",
"sh":"es",
"xp":"tw",
"ce":"lk",
"sj":"sd",
"sr":"sr",
"sq":"sz",
"sw":"se",
"sz":"ch",
"sy":"sy",
"ta":"tj",
"tz":"tz",
"tma":"au",
"th":"th",
"tg":"tg",
"tl":"tk",
"to":"to",
"tr":"tt",
"ti":"tn",
"tu":"tr",
"tk":"tm",
"tc":"tc",
"tv":"tv",
"ug":"ug",
"un":"ua",
"ts":"ae",
"enk":"gb",
"stk":"gb",
"wlk":"gb",
"xxk":"gb",
"nik":"gb",
"uik":"gb",
"xxu":"us",
"alu":"us",
"aku":"us",
"azu":"us",
"aru":"us",
"cau":"us",
"cou":"us",
"ctu":"us",
"deu":"us",
"flu":"us",
"gau":"us",
"hiu":"us",
"idu":"us",
"ilu":"us",
"inu":"us",
"iau":"us",
"ksu":"us",
"kyu":"us",
"lau":"us",
"meu":"us",
"mdu":"us",
"mau":"us",
"miu":"us",
"mnu":"us",
"msu":"us",
"mou":"us",
"mtu":"us",
"nbu":"us",
"nvu":"us",
"nhu":"us",
"nju":"us",
"nmu":"us",
"nyu":"us",
"ncu":"us",
"ndu":"us",
"ohu":"us",
"oku":"us",
"oru":"us",
"pau":"us",
"riu":"us",
"scu":"us",
"sdu":"us",
"tnu":"us",
"txu":"us",
"uc":"us",
"utu":"us",
"vtu":"us",
"vau":"us",
"wau":"us",
"wvu":"us",
"wiu":"us",
"wyu":"us",
"up":"pu",
"uy":"uy",
"uz":"uz",
"nn":"vu",
"vp":"xx",
"ve":"ve",
"vra":"au",
"vm":"vn",
"vi":"vi",
"wk":"wk",
"wf":"wf",
"wj":"ps",
"ss":"eh",
"ye":"ye",
"za":"zm",
"rh":"zw"
}
